{
  "colors": [
    {
      "name": "transparent",
      "colors": "transparent"
    },
    {
      "name": "black",
      "colors": "#000000"
    },
    {
      "name": "white",
      "colors": "#ffffff"
    },
    {
      "name": "gray",
      "colors": {
        "100": "#E4E7EB",
        "200": "#CBD2D9",
        "300": "#9AA5B1",
        "400": "#7B8794",
        "500": "#616E7C",
        "600": "#52606D",
        "700": "#3E4C59",
        "800": "#323F4B",
        "900": "#1F2933"
      }
    },
    {
      "name": "orange",
      "colors": {
        "100": "#FAB38B",
        "200": "#EF8E58",
        "300": "#E67635",
        "400": "#D25028",
        "500": "#C65D21",
        "600": "#AB4E19",
        "700": "#8C3D10",
        "800": "#77340D",
        "900": "#572508"
      }
    },
    {
      "name": "blue",
      "colors": {
        "100": "#D1EEFC",
        "200": "#A7D8F0",
        "300": "#7CC1E4",
        "400": "#55AAD4",
        "500": "#3994C1",
        "600": "#2D83AE",
        "700": "#1D6F98",
        "800": "#166086",
        "900": "#0B4F71"
      }
    },
    {
      "name": "purple",
      "colors": {
        "100": "#CFBCF2",
        "200": "#A081D9",
        "300": "#8662C7",
        "400": "#724BB7",
        "500": "#653CAD",
        "600": "#51279B",
        "700": "#421987",
        "800": "#34126F",
        "900": "#240754"
      }
    },
    {
      "name": "green",
      "colors": {
        "100": "#C1EAC5",
        "200": "#A3D9A5",
        "300": "#7BC47F",
        "400": "#57AE5B",
        "500": "#3F9142",
        "600": "#2F8132",
        "700": "#207227",
        "800": "#0E5814",
        "900": "#05400A"
      }
    },
    {
      "name": "red",
      "colors": {
        "100": "#FACDCD",
        "200": "#F29B9B",
        "300": "#E66A6A",
        "400": "#D64545",
        "500": "#BA2525",
        "600": "#A61B1B",
        "700": "#911111",
        "800": "#780A0A",
        "900": "#610404"
      }
    }
  ]
}